S	9	1	9	1
9	1	9	1	9
1	9	1	9	1
9	1	9	1	9
1	9	1	9	G