1	S	3	2	7	2	1	6	5	5	3	7	1	8	4	5	5	3	7	1	
5	7	2	4	1	8	8	2	2	2	7	7	8	1	2	7	2	1	5	5	
2	8	2	3	4	1	4	1	6	2	2	6	8	4	3	9	6	9	2	1	
9	6	9	8	5	3	8	4	7	9	6	1	7	8	8	9	9	1	4	9	
9	7	6	9	8	1	7	8	6	2	3	5	4	2	5	3	7	9	4	3	
3	9	9	2	3	6	3	6	6	5	2	7	5	6	8	3	7	9	1	3	
5	2	7	8	7	9	1	6	6	2	1	4	4	3	7	7	1	4	4	2	
6	9	2	6	5	6	8	7	7	4	2	7	4	2	1	2	9	2	4	1	
4	4	7	6	1	9	1	4	5	7	2	7	3	7	5	6	9	8	7	8	
1	3	3	5	7	4	3	8	2	8	6	3	1	4	5	2	7	7	6	3	
4	7	2	1	3	5	4	1	4	5	8	3	6	9	8	8	9	2	6	4	
5	7	2	4	4	4	6	3	2	2	5	7	1	3	2	5	3	3	2	5	
3	1	6	8	3	4	5	2	1	9	6	9	9	1	6	6	8	5	4	4	
1	3	4	4	4	7	3	8	3	9	1	5	9	2	5	1	4	7	3	4	
3	2	5	8	2	7	2	2	4	1	1	1	8	7	7	6	6	5	8	7	
6	4	5	1	1	1	8	1	8	7	4	5	7	3	1	4	6	6	1	7	
1	6	1	6	4	5	7	7	9	5	7	9	9	8	7	6	4	7	G	7	
8	8	7	3	8	6	5	3	8	9	4	6	1	2	6	4	7	1	7	8	
