9	9	9	9	G	6	7
2	4	7	4	5	2	2
4	3	3	2	8	8	3
7	7	7	7	7	7	7
2	3	4	5	6	7	8
8	7	6	5	4	2	S
