6	8	5	7	3	8	4	2	5	8	8	9	8	
S	3	1	9	2	4	9	3	1	9	5	4	1	
4	6	7	9	4	9	1	9	5	7	1	9	1	
4	9	1	5	2	7	7	6	1	2	9	9	4	
4	4	3	5	9	1	8	9	2	6	3	7	3	
8	3	9	4	7	5	2	2	9	5	2	8	9	
5	5	6	4	5	3	1	2	5	6	6	9	8	
1	8	5	5	7	4	7	4	2	3	2	5	3	
8	8	4	2	1	1	4	8	3	3	1	2	5	
6	8	3	3	6	2	9	7	6	2	7	8	5	
1	9	3	1	4	6	8	9	4	2	2	G	5	
6	8	6	9	1	6	7	3	1	1	7	4	7	
